
C 255,30,0
F 220,1,0

NO ./texture/Wall1.png
SO ./texture/Wall2.png
WE ./texture/Wall3.png
EA ./texture/Wall4.png

111111111111
10000000S001
100000000001
100000100001
100111100001
100100111001
100100000001
100000111001
100000001001
100000001001
111111111111
