C 255,30,0
F 220,1,0

NO ./texture/Wall1.png
SO ./texture/Wall2.png
WE ./texture/Wall3.png
EA ./texture/Wall4.png

11111
1N001
10001
10001
10001
10001
10001
10001
10001
10001
10001
10001
10001
10001
10001
10001
10001
10001
10001
11111