111111111111
100000000001
100000000001
100000100001
100111100001
100100111001
100100000001
100000111001
100000001001
100000001001
111111111111