11111111  11111111
10000001  10000001
10000001  10000001
111110011110011111
    1000000001
111110011110011111
10000001  10000001
10000001  10000001
11111111  11111111